timestamp,checkout,dairy,drinks,fruit,spices,sum
7,454,275,278,299,238,1544
8,677,455,348,468,342,2290
9,455,291,231,336,207,1520
10,427,294,198,270,242,1431
11,342,210,150,244,165,1111
12,384,225,188,247,208,1252
13,514,340,238,389,273,1754
14,496,319,229,345,261,1650
15,412,233,190,316,184,1335
16,518,337,272,353,262,1742
17,556,360,294,410,269,1889
18,630,425,361,453,346,2215
19,755,466,441,507,389,2558
20,492,298,307,312,246,1655
21,305,151,180,173,122,931
